20 20 10 1

#0#00#000#0#0#000#0#
00##0###0#0#0#0###0#
#0#0###00#000#000##0
#0#00#000###0#000#0#
####################
#0#00#000#0#0#000#0#
00##0###0#0#0#0###0#
#0#0###00#000#000##0
#0#00#000###0#000#0#
####################
#0#00#000#0#0#000#0#
00##0###0#0#0#0###0#
#0#0###00#000#000##0
#0#00#000###0#000#0#
####################
#0#00#000#0#0#000#0#
00##0###0#0#0#0###0#
#0#0###00#000#000##0
#0#00#000###0#000#0#
####################