10 10 1

.#.#######
#.########
##.###.#-#
#f########
###..#####
^^^^^^^^^^
0000000000
00000*0000
00*0000000
0000000000