10 10 1

**000000**
**000000**
0000000000
000****000
000****000
000****000
000****000
0000000000
**000000**
**000000**
